*^**************
*..............*
*..............*
*..............*
*..............*
*..............*
*..............*
*..............*
*..............*
*..............*
*..............*
*.**************
. = ["cave", {"type": "walk"}]
^ = ["cavemouth", {"type": "gateway", "dest": "first", "pos": [1, 4]}]

