*^**************
*..............*
*.......*......*
*******$*......*
*.......*......*
*.......*......*
*.......*......*
*.......*......*
*..............*
*.*******......*
*.......*......*
*.**************
. = ["cave", {"type": "walk"}]
$ = ["stone", {"type": "walk"}]
^ = ["cavemouth", {"type": "gateway", "dest": "first", "pos": [1, 4]}]
aiPath = "."

