***         ****
**             *
*              *
*              *
      *        *
      **       *
      **       *
       *       *
              **
*             **
**          ****
****%%%%%%%*****
% = ["ground", {"type": "border", "dest": "second"}]

